##########
#@..#.#..#
###.#.#.##
#.....#..#
#.######.#
#..#.....#
#.####.###
#........#
##########